NO ./textures_bloody/North.xpm
SO ./textures_bloody/South.xpm
WE ./textures_bloody/West.xpm
EA ./textures_bloody/East.xpm
DR  ./textures2/N.xpm

F 151, 22, 23
C 0,0,0

11111111111
10000010001
10000010001
10000010001
1000W0D0001
10000010001
11111111111