NO ./test_maps/textures/north.xpm
SO ./test_maps/textures/south.xpm
WE ./test_maps/textures/west.xpm
EA ./test_maps/textures/east.xpm

F 255,0,0
C 0,0,255

1111111
1000001
1000N01
1111111
