NO ./test_maps/textures/north.xpm
SO ./test_maps/textures/south.xpm
WE ./test_maps/textures/west.xpm
EA ./test_maps/textures/east.xpm

F 220,100,0
C 225,30,0

1111111
1000001
100 001
1000N01
1111111
