NO ./textures/North.xpm
SO ./textures/South.xpm
WE ./textures/West.xpm
EA ./textures/East.xpm

F 220,100,0
C 225,30,0

1111111
1000001
10X0N01
1111111
