NO ./textures/North.xpm
SO ./textures/South.xpm
WE ./textures/West.xpm
EA ./textures/East.xpm

F 100,100,100
C 50,50,50

11111111111111111111111111111
10000000001000000000100000001
10111111101011111110101111101
10100000001000000010100000101
10101111111111110010111110101
10100000000000010010000010101
10111111111111010011110010101
10000000000001010000010000101
11111111111101011111010111101
10000000000001000000010000001
10111111111111111111111111101
10100000000000000000000000101
10101111111111111111111110101
10101000000000000000000010101
10101011111111111111110010101
10101010000000000000010010101
10101010111111111110010010101
10101010100000000010010010101
10101010101111111010010010101
10101000101000001010010010101
10101110101011101010010010101
10100010101010001010010000101
10111010101010111010011110101
10000010001010000010000000101
11111111111010111111111111101
10000000001010000000000000001
10111111101011111111111111101
10100000001000000000000000001
10101111111111111111111111111
1010000000000000000000000000N1
11111111111111111111111111111
