NO ./textures/North.xpm
SO ./textures/South.xpm
WE ./textures/West.xpm
EA ./textures/East.xpm
F 255,0,0
C 0,255,255
11111111111
10000000001
10000000001
1000N000001
10000000001
10000000001
11111111111